11000000111100000111
01111100100100000100
00000111100100011100
00000100000000010000
01111100010000011110
01000000010000000010
01111111110000000010
00010000000001111110
00010000111111000000
*1111111100000000000