11100000111100000000
0010000010000$010000
00100111111110010000
00100100000100010000
00100100000100011100
00111100000100000100
00000100000100000100
00111100000111111*00
00100000000000000000
00100000000000000000