1110000000000011111*
00100001111111100000
00110001000000000000
00010001111100000000
00010000000100111110
00011111000100100010
00000001111111100010
00000000000000000010
01111000111111111110
0$001111100000000000