11100000000000222222
00100002222222200000
00110002000000000000
00010002222200000000
00010000000200222220
00011111000200200020
00000001111222200020
00000000000000000020
02222000222222222220
0$002222200000000000
