*0000000000000000000
11100000000011110000
00111100111110010000
00000100100010010000
01111111100010011111
01000000000010000000
01000000011110000000
011111000100001111$0
00000100011111100000
00111100000000000000